Date,No of Transactions,high,low,adjclose,Traded Shares,Total Amount,open,Difference Rs.,% Change
10/16/2016,35,1800,1760,1770,2605,4642309,1780,-10,-0.56
10/17/2016,26,1780,1743,1774,4532,8004906,1770,4,0.23
10/18/2016,36,1800,1746,1789,4476,7905350,1774,15,0.85
10/19/2016,37,1795,1781,1790,3025,5418074,1789,1,0.06
10/20/2016,32,1790,1775,1785,4051,7223760,1790,-5,-0.28
10/23/2016,52,1785,1762,1765,8690,15381286,1785,-20,-1.12
10/24/2016,63,1770,1740,1740,10127,17718410,1765,-25,-1.42
10/25/2016,30,1741,1702,1729,2830,4889092,1740,-11,-0.63
10/26/2016,48,1744,1705,1740,6550,11272100,1729,11,0.64
10/27/2016,33,1755,1730,1755,3259,5680460,1740,15,0.86
11/3/2016,36,1795,1760,1760,5932,10583365,1755,5,0.28
11/7/2016,34,1760,1735,1739,4023,7029454,1760,-21,-1.19
11/8/2016,39,1758,1712,1725,3671,6313451,1739,-14,-0.81
11/9/2016,59,1716,1675,1708,5692,9680421,1725,-17,-0.99
11/10/2016,93,1710,1697,1700,8482,14451732,1708,-8,-0.47
11/13/2016,61,1720,1690,1703,9265,15814689,1700,3,0.18
11/14/2016,38,1730,1703,1722,4633,7970265,1703,19,1.12
11/15/2016,48,1725,1710,1716,4705,8079617,1722,-6,-0.35
11/16/2016,51,1721,1695,1695,6094,10400900,1716,-21,-1.22
11/17/2016,77,1705,1660,1670,8823,14794812,1695,-25,-1.47
11/20/2016,68,1650,1596,1630,8592,13882593,1670,-40,-2.4
11/21/2016,45,1680,1605,1635,5441,8855012,1630,5,0.31
11/22/2016,67,1655,1605,1630,7277,11888214,1635,-5,-0.31
11/23/2016,68,1626,1596,1600,8590,13764315,1630,-30,-1.84
11/24/2016,61,1610,1589,1595,6007,9588915,1600,-5,-0.31
11/27/2016,56,1588,1540,1555,4670,7327037,1595,-40,-2.51
11/28/2016,98,1640,1450,1640,10412,15581669,1555,85,5.47
11/29/2016,72,1655,1600,1655,7847,12789990,1640,15,0.91
11/30/2016,70,1700,1640,1691,7451,12521920,1655,36,2.18
12/1/2016,79,1734,1652,1674,7265,12248557,1691,-17,-1.01
12/4/2016,47,1670,1600,1670,4200,6890404,1674,-4,-0.24
12/5/2016,28,1690,1610,1640,2489,4064153,1670,-30,-1.8
12/6/2016,29,1650,1618,1638,2942,4780580,1640,-2,-0.12
12/7/2016,19,1640,1625,1635,944,1543130,1638,-3,-0.18
12/8/2016,19,1635,1616,1630,2418,3924004,1635,-5,-0.31
12/11/2016,26,1615,1600,1600,2229,3579929,1630,-30,-1.84
12/12/2016,37,1605,1590,1590,3275,5234640,1600,-10,-0.63
12/14/2016,42,1605,1575,1580,3618,5728110,1590,-10,-0.63
12/15/2016,37,1596,1565,1580,3144,4969905,1580,0,0
12/18/2016,23,1590,1565,1575,2536,3988415,1580,-5,-0.32
12/19/2016,47,1581,1571,1580,6814,10728686,1575,5,0.32
12/20/2016,53,1581,1565,1570,4956,7777705,1580,-10,-0.63
12/21/2016,25,1561,1530,1533,2243,3458589,1570,-37,-2.36
12/22/2016,45,1540,1524,1530,4389,6725386,1533,-3,-0.2
12/26/2016,59,1518,1500,1508,5860,8839205,1530,-22,-1.44
12/27/2016,45,1500,1421,1479,3491,5120574,1508,-29,-1.92
12/28/2016,64,1485,1450,1475,6181,9075222,1479,-4,-0.27
12/29/2016,38,1519,1481,1519,3186,4769867,1475,44,2.98
1/1/2017,42,1548,1525,1530,3097,4755293,1519,11,0.72
1/2/2017,57,1550,1525,1544,10617,16338631,1530,14,0.92
1/3/2017,68,1550,1525,1525,5907,9065006,1544,-19,-1.23
1/4/2017,14,1529,1515,1515,1430,2179380,1525,-10,-0.66
1/5/2017,41,1520,1500,1505,4175,6307494,1515,-10,-0.66
1/8/2017,26,1510,1495,1510,2781,4176835,1505,5,0.33
1/9/2017,21,1529,1510,1519,1389,2106767,1510,9,0.6
1/10/2017,35,1551,1525,1538,3248,5014861,1519,19,1.25
1/11/2017,37,1565,1540,1565,4054,6277188,1538,27,1.76
1/12/2017,32,1565,1546,1560,1982,3080102,1565,-5,-0.32
1/15/2017,34,1550,1530,1540,2316,3569530,1560,-20,-1.28
1/16/2017,52,1540,1505,1508,5298,8008643,1540,-32,-2.08
1/17/2017,39,1525,1500,1505,3743,5639426,1508,-3,-0.2
1/18/2017,54,1512,1490,1504,5013,7523545,1505,-1,-0.07
1/19/2017,39,1515,1500,1500,3585,5400055,1504,-4,-0.27
1/22/2017,34,1515,1500,1506,2713,4089847,1500,6,0.4
1/23/2017,33,1516,1500,1500,2874,4328142,1506,-6,-0.4
1/24/2017,43,1500,1481,1487,2963,4416101,1500,-13,-0.87
1/25/2017,92,1459,1426,1441,7828,11287504,1487,-46,-3.09
1/26/2017,72,1445,1400,1432,4524,6429933,1441,-9,-0.62
1/30/2017,103,1425,1350,1365,6198,8563164,1432,-67,-4.68
1/31/2017,75,1390,1304,1390,7174,9654758,1365,25,1.83
2/1/2017,69,1450,1400,1442,5711,8122880,1390,52,3.74
2/2/2017,69,1485,1440,1455,5462,7967835,1442,13,0.9
2/5/2017,39,1480,1412,1455,4887,7173313,1455,0,0
2/6/2017,39,1455,1420,1420,3203,4593482,1455,-35,-2.41
2/7/2017,70,1422,1400,1405,7394,10392930,1420,-15,-1.06
2/8/2017,69,1420,1382,1395,6077,8465459,1405,-10,-0.71
2/9/2017,70,1391,1370,1370,4797,6617816,1395,-25,-1.79
2/12/2017,134,1343,1295,1305,11250,14703980,1370,-65,-4.74
2/13/2017,107,1380,1275,1370,10589,13734117,1305,65,4.98
2/14/2017,102,1375,1346,1360,8847,12054626,1370,-10,-0.73
2/15/2017,71,1412,1370,1412,6199,8619869,1360,52,3.82
2/16/2017,118,1458,1415,1456,7547,10916859,1412,44,3.12
2/19/2017,91,1500,1427,1496,7010,10368340,1456,40,2.75
2/20/2017,98,1549,1510,1520,7377,11253485,1496,24,1.6
2/21/2017,96,1550,1495,1515,7723,11784598,1520,-5,-0.33
2/22/2017,36,1505,1475,1485,1883,2804625,1515,-30,-1.98
2/23/2017,37,1485,1465,1471,2710,3984496,1485,-14,-0.94
2/26/2017,51,1470,1405,1405,4770,6842345,1471,-66,-4.49
2/28/2017,48,1400,1377,1395,4357,6066336,1405,-10,-0.71
3/1/2017,69,1407,1388,1400,8356,11667455,1395,5,0.36
3/2/2017,37,1421,1401,1420,3487,4935667,1400,20,1.43
3/5/2017,41,1461,1395,1450,5909,8561833,1420,30,2.11
3/6/2017,58,1470,1451,1469,3287,4814614,1450,19,1.31
3/7/2017,60,1450,1424,1435,4045,5804665,1469,-34,-2.31
3/9/2017,26,1463,1436,1436,3014,4353264,1435,1,0.07
3/13/2017,19,1460,1435,1455,2366,3423835,1436,19,1.32
3/14/2017,17,1465,1440,1449,1385,2011608,1455,-6,-0.41
3/15/2017,16,1449,1421,1440,1235,1775926,1449,-9,-0.62
3/16/2017,38,1449,1431,1440,3233,4653160,1440,0,0
3/19/2017,48,1446,1430,1440,4640,6673702,1440,0,0
3/20/2017,83,1465,1440,1460,10234,14841723,1440,20,1.39
3/21/2017,80,1475,1450,1475,7625,11154867,1460,15,1.03
3/22/2017,107,1538,1480,1481,12277,18575436,1475,6,0.41
3/23/2017,75,1499,1465,1470,8543,12629357,1481,-11,-0.74
3/26/2017,109,1529,1480,1500,14931,22420877,1470,30,2.04
3/28/2017,75,1581,1529,1575,9939,15514194,1500,75,5
3/29/2017,150,1606,1550,1570,18088,28454445,1575,-5,-0.32
3/30/2017,86,1570,1541,1550,9746,15116519,1570,-20,-1.27
4/2/2017,55,1591,1560,1579,8810,13863282,1550,29,1.87
4/3/2017,130,1716,1550,1577,15195,24944664,1579,-2,-0.13
4/4/2017,82,1594,1550,1580,8995,14130868,1577,3,0.19
4/6/2017,52,1580,1556,1570,5503,8628837,1580,-10,-0.63
4/9/2017,59,1585,1539,1568,4935,7720480,1570,-2,-0.13
4/10/2017,70,1575,1550,1575,8280,12919959,1568,7,0.45
4/11/2017,84,1628,1592,1600,9167,14675019,1575,25,1.59
4/12/2017,84,1635,1592,1615,8132,13110570,1600,15,0.94
4/13/2017,63,1600,1565,1590,4916,7804592,1615,-25,-1.55
4/16/2017,45,1590,1540,1556,2911,4562607,1590,-34,-2.14
4/18/2017,53,1556,1515,1515,2972,4530449,1556,-41,-2.64
4/19/2017,37,1545,1500,1540,3753,5710446,1515,25,1.65
4/20/2017,35,1570,1540,1551,4148,6434092,1540,11,0.71
4/23/2017,53,1650,1580,1599,7475,12119151,1551,48,3.09
4/24/2017,47,1600,1575,1599,4041,6412340,1599,0,0
4/25/2017,36,1596,1570,1590,3009,4753538,1599,-9,-0.56
4/26/2017,29,1579,1565,1574,2038,3204084,1590,-16,-1.01
4/27/2017,34,1581,1557,1580,3571,5613711,1574,6,0.38
4/30/2017,41,1580,1545,1545,6533,10180389,1580,-35,-2.22
5/2/2017,36,1545,1535,1535,2341,3607072,1545,-10,-0.65
5/3/2017,37,1596,1560,1569,3461,5428952,1535,34,2.22
5/4/2017,44,1570,1552,1560,2743,4297693,1569,-9,-0.57
5/7/2017,33,1560,1525,1535,3218,4934049,1560,-25,-1.6
5/8/2017,34,1564,1520,1540,2702,4129491,1535,5,0.33
5/9/2017,34,1580,1550,1560,2023,3151900,1540,20,1.3
5/11/2017,38,1570,1560,1560,2672,4180311,1560,0,0
5/15/2017,42,1577,1560,1560,3167,4954540,1560,0,0
5/16/2017,20,1560,1536,1558,1888,2926720,1560,-2,-0.13
5/17/2017,39,1560,1550,1560,2503,3897343,1558,2,0.13
5/18/2017,62,1565,1540,1554,5123,7941445,1560,-6,-0.38
5/21/2017,26,1560,1535,1550,1204,1869835,1554,-4,-0.26
5/22/2017,22,1559,1535,1535,1271,1959285,1550,-15,-0.97
6/1/2017,85,1525,1495,1500,8966,13506747,1500,0,0
6/4/2017,77,1501,1470,1480,8738,12917926,1500,-20,-1.33
6/5/2017,34,1509,1480,1500,3695,5530476,1480,20,1.35
6/6/2017,96,1530,1500,1519,8003,12067235,1500,19,1.27
6/7/2017,69,1540,1514,1515,10804,16424306,1519,-4,-0.26
6/8/2017,36,1515,1500,1512,3132,4713197,1515,-3,-0.2
6/11/2017,72,1512,1470,1472,6190,9211705,1512,-40,-2.65
6/12/2017,97,1479,1451,1460,9507,13894083,1472,-12,-0.82
6/13/2017,57,1479,1455,1460,5712,8357364,1460,0,0
6/14/2017,91,1460,1450,1452,10596,15412170,1460,-8,-0.55
6/15/2017,40,1504,1458,1480,4356,6413088,1452,28,1.93
6/18/2017,41,1480,1453,1459,3120,4601959,1480,-21,-1.42
6/19/2017,66,1460,1445,1450,6395,9297531,1459,-9,-0.62
6/20/2017,49,1455,1436,1442,4585,6621680,1450,-8,-0.55
6/21/2017,32,1460,1450,1460,3699,5393372,1442,18,1.25
6/22/2017,46,1484,1451,1452,3172,4636934,1460,-8,-0.55
6/25/2017,55,1490,1465,1489,3963,5871812,1452,37,2.55
6/27/2017,49,1499,1485,1491,3543,5280813,1489,2,0.13
6/28/2017,42,1500,1485,1499,4402,6571007,1491,8,0.54
7/2/2017,56,1499,1460,1479,3363,4948199,1499,-20,-1.33
7/3/2017,27,1480,1470,1475,2096,3090420,1479,-4,-0.27
7/4/2017,40,1479,1472,1476,2778,4098059,1475,1,0.07
7/5/2017,31,1485,1475,1475,2783,4111579,1476,-1,-0.07
7/6/2017,41,1500,1475,1500,3154,4686720,1475,25,1.69
7/9/2017,74,1525,1490,1500,6988,10562849,1500,0,0
7/10/2017,55,1505,1490,1493,6071,9080538,1500,-7,-0.47
7/11/2017,29,1510,1500,1506,3583,5394980,1493,13,0.87
7/12/2017,36,1520,1510,1519,2244,3394055,1506,13,0.86
7/13/2017,39,1525,1512,1523,2709,4113818,1519,4,0.26
7/16/2017,29,1530,1500,1530,2912,4434776,1523,7,0.46
7/17/2017,100,1599,1540,1597,11170,17515322,1530,67,4.38
7/18/2017,150,1650,1599,1638,12310,20156563,1597,41,2.57
7/19/2017,148,1670,1650,1658,12595,20914375,1638,20,1.22
7/20/2017,85,1670,1656,1658,6554,10892528,1658,0,0
7/23/2017,64,1665,1630,1635,4811,7920541,1658,-23,-1.39
7/24/2017,78,1650,1600,1610,4650,7517602,1635,-25,-1.53
7/25/2017,54,1620,1607,1612,5546,8936508,1610,2,0.12
7/26/2017,43,1643,1612,1620,3897,6361000,1612,8,0.5
7/27/2017,65,1640,1625,1627,4790,7802785,1620,7,0.43
7/30/2017,44,1630,1610,1620,3503,5680620,1627,-7,-0.43
7/31/2017,41,1629,1620,1622,3329,5407310,1620,2,0.12
8/1/2017,54,1642,1625,1635,3486,5687953,1622,13,0.8
8/2/2017,49,1640,1630,1638,4095,6688292,1635,3,0.18
8/3/2017,184,1675,1652,1667,15706,26155939,1638,29,1.77
8/6/2017,197,1733,1700,1728,18127,31218211,1667,61,3.66
8/7/2017,160,1773,1750,1768,17674,31186114,1728,40,2.31
8/9/2017,131,1798,1775,1780,12288,21922842,1768,12,0.68
8/10/2017,117,1779,1736,1758,10168,17881898,1780,-22,-1.24
8/13/2017,91,1769,1745,1750,9970,17482991,1758,-8,-0.46
8/15/2017,64,1749,1720,1720,5048,8758193,1750,-30,-1.71
8/16/2017,84,1735,1713,1718,7982,13756714,1720,-2,-0.12
8/17/2017,94,1751,1710,1737,10056,17274511,1718,19,1.11
8/20/2017,66,1760,1732,1735,5888,10259197,1737,-2,-0.12
8/21/2017,43,1730,1715,1720,3081,5297040,1735,-15,-0.86
8/22/2017,54,1730,1717,1729,5422,9343100,1720,9,0.52
8/23/2017,65,1740,1730,1730,4741,8214588,1729,1,0.06
8/24/2017,48,1730,1718,1729,4183,7206550,1730,-1,-0.06
8/27/2017,316,1810,1755,1767,31262,55313492,1729,38,2.2
8/28/2017,283,1799,1758,1762,20703,36640894,1767,-5,-0.28
8/30/2017,163,1770,1722,1737,11486,20085496,1762,-25,-1.42
8/31/2017,180,1750,1699,1700,13665,23374198,1737,-37,-2.13
9/4/2017,164,1701,1640,1665,13365,22238967,1700,-35,-2.06
9/6/2017,236,1715,1670,1694,19799,33552418,1665,29,1.74
9/7/2017,313,1700,1675,1675,28839,48861153,1694,-19,-1.12
9/10/2017,374,1688,1632,1634,29951,49273019,1675,-41,-2.45
9/11/2017,760,1650,1613,1630,63239,103382819,1634,-4,-0.24
9/12/2017,186,1235,1191,1191,16172,19436411,1254,-63,-5.02
9/13/2017,83,1190,1170,1185,6694,7895425,1191,-6,-0.5
9/14/2017,115,1210,1189,1205,9574,11452752,1185,20,1.69
9/17/2017,129,1255,1210,1245,8537,10589205,1205,40,3.32
9/18/2017,101,1270,1255,1264,6829,8639064,1245,19,1.53
9/20/2017,97,1274,1254,1254,5611,7065724,1264,-10,-0.79
9/24/2017,87,1260,1242,1254,8497,10628509,1254,0,0
9/25/2017,38,1265,1258,1260,2474,3118727,1254,6,0.48
9/26/2017,52,1265,1251,1264,6134,7709872,1260,4,0.32
10/3/2017,27,1265,1243,1265,1586,1988128,1264,1,0.08
10/4/2017,44,1269,1245,1245,5471,6875981,1265,-20,-1.58
10/8/2017,72,1245,1200,1218,5817,7046017,1245,-27,-2.17
10/9/2017,80,1225,1200,1205,6902,8301697,1218,-13,-1.07
10/10/2017,30,1211,1190,1205,2185,2631375,1205,0,0
10/11/2017,71,1209,1199,1200,5616,6749975,1205,-5,-0.41
10/12/2017,63,1205,1195,1200,6344,7616025,1200,0,0
10/15/2017,26,1219,1200,1219,1432,1731988,1200,19,1.58
10/16/2017,64,1285,1220,1285,6273,7799850,1219,66,5.41
10/17/2017,64,1291,1265,1273,6476,8271853,1285,-12,-0.93
10/18/2017,42,1280,1264,1277,4812,6117000,1273,4,0.31
10/22/2017,16,1285,1270,1272,1070,1368105,1277,-5,-0.39
10/23/2017,30,1280,1260,1265,1708,2169615,1272,-7,-0.55
10/24/2017,24,1270,1251,1257,2908,3659420,1265,-8,-0.63
10/25/2017,32,1265,1235,1235,2350,2930820,1257,-22,-1.75
10/29/2017,37,1240,1225,1230,2416,2973525,1235,-5,-0.4
10/30/2017,51,1234,1220,1225,5881,7210045,1230,-5,-0.41
10/31/2017,43,1225,1210,1219,4315,5238973,1225,-6,-0.49
11/1/2017,42,1235,1220,1220,3253,3979235,1219,1,0.08
11/2/2017,69,1230,1208,1215,7706,9364149,1220,-5,-0.41
11/5/2017,70,1210,1194,1203,7767,9320970,1215,-12,-0.99
11/6/2017,72,1200,1180,1190,5666,6764751,1203,-13,-1.08
11/7/2017,95,1195,1175,1179,9207,10893020,1190,-11,-0.92
11/8/2017,64,1180,1165,1165,4291,5028682,1179,-14,-1.19
11/9/2017,177,1165,1130,1130,18364,20877641,1165,-35,-3
11/12/2017,80,1150,1121,1150,10024,11359344,1130,20,1.77
11/13/2017,100,1165,1150,1161,10925,12632188,1150,11,0.96
11/14/2017,81,1200,1163,1200,11066,13012931,1161,39,3.36
11/15/2017,98,1208,1197,1200,8902,10679752,1200,0,0
11/16/2017,51,1200,1180,1182,4677,5558767,1200,-18,-1.5
11/19/2017,29,1200,1168,1168,2558,3011830,1182,-14,-1.18
11/20/2017,85,1157,1140,1140,11937,13682716,1168,-28,-2.4
11/21/2017,52,1162,1130,1145,4337,4981260,1140,5,0.44
11/22/2017,32,1168,1160,1166,3050,3551417,1145,21,1.83
11/23/2017,54,1175,1166,1166,5085,5958916,1166,0,0
11/26/2017,51,1180,1170,1175,7461,8771195,1166,9,0.77
11/27/2017,48,1184,1160,1165,7045,8269855,1175,-10,-0.85
11/28/2017,43,1180,1165,1180,5031,5925569,1165,15,1.29
11/29/2017,56,1190,1180,1180,11254,13340119,1180,0,0
11/30/2017,59,1190,1170,1179,8116,9533877,1180,-1,-0.08
12/4/2017,45,1181,1166,1166,4406,5182918,1179,-13,-1.1
12/5/2017,42,1170,1155,1170,4113,4771619,1166,4,0.34
12/6/2017,45,1180,1165,1168,4018,4716696,1170,-2,-0.17
12/10/2017,68,1176,1155,1164,9654,11249659,1168,-4,-0.34
12/11/2017,36,1167,1152,1167,2773,3216181,1164,3,0.26
12/12/2017,12,1170,1153,1160,950,1104025,1167,-7,-0.6
12/13/2017,23,1160,1155,1156,2013,2332412,1160,-4,-0.34
12/14/2017,9,1169,1159,1160,1117,1297193,1156,4,0.35
12/17/2017,37,1160,1150,1155,3691,4269481,1160,-5,-0.43
12/18/2017,23,1164,1160,1160,1545,1794115,1155,5,0.43
12/19/2017,26,1161,1155,1155,2366,2738360,1160,-5,-0.43
12/20/2017,33,1160,1145,1155,2665,3077286,1155,0,0
12/21/2017,35,1160,1145,1149,4245,4876851,1155,-6,-0.52
12/24/2017,42,1155,1148,1150,4231,4869175,1149,1,0.09
12/26/2017,32,1155,1130,1145,2029,2324230,1150,-5,-0.43
12/27/2017,41,1143,1130,1134,2831,3218527,1145,-11,-0.96
12/28/2017,151,1129,1085,1090,15690,17372804,1134,-44,-3.88
12/31/2017,174,1090,1015,1020,19263,19872468,1090,-70,-6.42
1/1/2018,100,1065,1020,1065,15122,15815821,1020,45,4.41
1/2/2018,172,1101,1065,1080,24418,26436586,1065,15,1.41
1/3/2018,95,1100,1050,1055,12532,13419655,1080,-25,-2.31
1/4/2018,64,1081,1059,1080,7265,7729842,1055,25,2.37
1/7/2018,91,1090,1074,1081,8667,9375573,1080,1,0.09
1/8/2018,92,1097,1080,1089,14120,15355520,1081,8,0.74
1/9/2018,83,1100,1089,1090,9727,10622378,1089,1,0.09
1/10/2018,112,1093,1070,1070,12309,13268074,1090,-20,-1.83
1/14/2018,89,1073,1055,1065,9390,9958623,1070,-5,-0.47
1/16/2018,197,1066,1025,1030,22276,22954807,1065,-35,-3.29
1/17/2018,159,1045,1010,1039,20617,21075039,1030,9,0.87
1/21/2018,126,1045,1025,1039,12003,12403365,1039,0,0
1/22/2018,76,1043,1033,1039,11946,12404528,1039,0,0
1/23/2018,74,1040,1030,1031,6612,6832655,1039,-8,-0.77
1/24/2018,177,1032,1010,1015,19823,20147654,1031,-16,-1.55
1/25/2018,77,1039,1020,1037,8156,8413375,1015,22,2.17
1/28/2018,115,1055,1044,1048,10059,10552455,1037,11,1.06
1/29/2018,127,1055,1045,1052,11653,12243536,1048,4,0.38
1/31/2018,120,1070,1058,1070,10033,10680085,1052,18,1.71
2/1/2018,145,1098,1075,1090,12664,13798913,1070,20,1.87
2/4/2018,155,1099,1086,1086,19894,21733406,1090,-4,-0.37
2/5/2018,119,1092,1074,1077,12146,13121803,1086,-9,-0.83
2/6/2018,69,1073,1065,1072,4578,4892085,1077,-5,-0.46
2/7/2018,75,1066,1060,1066,7436,7896306,1072,-6,-0.56
2/8/2018,78,1070,1057,1065,8717,9272016,1066,-1,-0.09
2/11/2018,69,1070,1060,1070,6351,6760781,1065,5,0.47
2/12/2018,73,1074,1061,1062,6125,6533434,1070,-8,-0.75
2/14/2018,98,1075,1060,1068,11870,12624699,1062,6,0.57
2/15/2018,159,1104,1075,1104,18692,20360424,1068,36,3.37
2/18/2018,186,1126,1106,1112,19540,21802656,1104,8,0.72
2/20/2018,113,1130,1093,1100,9378,10334586,1112,-12,-1.08
2/21/2018,41,1096,1085,1095,2594,2833586,1100,-5,-0.45
2/22/2018,85,1100,1086,1090,8036,8754206,1095,-5,-0.46
2/25/2018,97,1090,1065,1070,10593,11396582,1090,-20,-1.83
2/26/2018,98,1085,1059,1059,12348,13147101,1070,-11,-1.03
2/27/2018,64,1075,1055,1068,19270,20383380,1059,9,0.85
2/28/2018,113,1067,1055,1060,12588,13355553,1068,-8,-0.75
3/4/2018,137,1045,1022,1034,13490,13943999,1060,-26,-2.45
3/5/2018,95,1070,1031,1035,9593,9930691,1034,1,0.1
3/6/2018,88,1060,1025,1050,15880,16382778,1035,15,1.45
3/7/2018,142,1065,1051,1060,21280,22518994,1050,10,0.95
3/11/2018,111,1060,1040,1044,11768,12328304,1060,-16,-1.51
3/12/2018,95,1043,1035,1043,8110,8421984,1044,-1,-0.1
3/13/2018,141,1041,1024,1030,14786,15241365,1043,-13,-1.25
3/14/2018,107,1040,1030,1030,9600,9895232,1030,0,0
3/15/2018,151,1035,1023,1023,11196,11519949,1030,-7,-0.68
3/18/2018,110,1029,1019,1025,12162,12445533,1023,2,0.2
3/19/2018,122,1030,1012,1015,12030,12261050,1025,-10,-0.98
3/20/2018,171,1015,998,1015,23717,23766543,1015,0,0
3/21/2018,266,1001,985,985,20783,20629079,1015,-30,-2.96
3/22/2018,215,990,969,975,20012,19557394,985,-10,-1.02
3/26/2018,209,965,920,925,16921,15870121,975,-50,-5.13
3/27/2018,225,950,888,939,25557,23304842,925,14,1.51
3/28/2018,214,968,931,968,23753,22625884,939,29,3.09
3/29/2018,213,987,967,970,18810,18319193,968,2,0.21
4/1/2018,186,975,917,945,15347,14400984,970,-25,-2.58
4/2/2018,99,949,937,945,8678,8183555,945,0,0
4/3/2018,113,950,939,950,11371,10755354,945,5,0.53
4/4/2018,143,965,950,965,16959,16258088,950,15,1.58
4/5/2018,268,978,965,970,27949,27130865,965,5,0.52
4/8/2018,270,1010,972,999,31730,31438392,970,29,2.99
4/9/2018,356,1030,994,994,35267,35649958,999,-5,-0.5
4/10/2018,138,1000,980,986,11944,11843749,994,-8,-0.8
4/11/2018,79,994,980,988,8026,7922823,986,2,0.2
4/12/2018,115,999,988,989,14218,14093564,988,1,0.1
4/15/2018,105,999,979,990,13102,12926814,989,1,0.1
4/16/2018,65,999,980,996,8325,8269895,990,6,0.61
4/17/2018,127,1005,997,1002,16009,16014884,996,6,0.6
4/18/2018,128,1050,999,1040,21999,22542958,1002,38,3.79
4/19/2018,179,1060,1041,1055,15695,16510904,1040,15,1.44
4/22/2018,210,1076,1058,1065,20691,22041196,1055,10,0.95
4/23/2018,180,1081,1050,1050,16208,17342320,1065,-15,-1.41
4/24/2018,114,1064,1032,1032,8229,8577428,1050,-18,-1.71
4/25/2018,89,1045,1030,1040,10589,10957803,1032,8,0.78
4/26/2018,97,1050,1020,1030,13380,13834533,1040,-10,-0.96
4/29/2018,90,1020,1002,1013,7378,7486292,1030,-17,-1.65
5/2/2018,91,1025,996,1009,10811,10833777,1013,-4,-0.39
5/3/2018,70,1025,1009,1009,6662,6759592,1009,0,0
5/6/2018,70,1006,1000,1005,6340,6357513,1009,-4,-0.4
5/7/2018,71,1010,998,999,6050,6056230,1005,-6,-0.6
5/8/2018,56,1010,997,1010,8831,8852104,999,11,1.1
5/9/2018,65,1014,1003,1003,7968,8034051,1010,-7,-0.69
5/10/2018,42,1010,996,1003,3212,3220711,1003,0,0
5/14/2018,80,1004,990,1000,8898,8893275,1003,-3,-0.3
5/15/2018,31,1007,995,1002,2596,2600618,1000,2,0.2
5/16/2018,48,1002,999,1000,6058,6059488,1002,-2,-0.2
5/17/2018,42,1005,1001,1002,3295,3305126,1000,2,0.2
5/20/2018,84,1022,1000,1000,9372,9407270,1002,-2,-0.2
5/21/2018,57,1010,996,999,6405,6406075,1000,-1,-0.1
5/22/2018,50,1003,995,995,6365,6353640,999,-4,-0.4
5/23/2018,64,999,984,987,5655,5608070,995,-8,-0.8
5/24/2018,55,999,990,990,5307,5272846,987,3,0.3
5/27/2018,43,990,978,989,3069,3025613,990,-1,-0.1
5/28/2018,35,1012,985,1012,4170,4168432,989,23,2.33
5/29/2018,52,1010,999,999,4198,4215660,1012,-13,-1.28
5/30/2018,33,1013,999,1000,2360,2369794,999,1,0.1
5/31/2018,46,1005,995,1000,3164,3164745,1000,0,0
6/3/2018,73,1000,980,980,5913,5851885,1000,-20,-2
6/4/2018,60,985,970,979,3875,3778918,980,-1,-0.1
6/6/2018,30,1000,988,990,1882,1870275,979,11,1.12
6/7/2018,72,990,975,975,4786,4699557,990,-15,-1.52
6/10/2018,72,970,944,956,5466,5203139,975,-19,-1.95
6/11/2018,63,975,945,955,5198,4985404,956,-1,-0.1
6/12/2018,35,960,945,955,4558,4348302,955,0,0
6/13/2018,50,960,945,955,3803,3623053,955,0,0
6/14/2018,20,963,955,958,947,908810,955,3,0.31
6/17/2018,34,959,940,942,3161,3005848,958,-16,-1.67
6/18/2018,45,955,937,943,2878,2708792,942,1,0.11
6/19/2018,24,944,940,941,1365,1284805,943,-2,-0.21
6/20/2018,35,945,940,940,3344,3150990,941,-1,-0.11
6/21/2018,36,945,940,942,2308,2172544,940,2,0.21
6/24/2018,53,943,936,942,4494,4227179,942,0,0
6/25/2018,54,945,930,932,4988,4659460,942,-10,-1.06
6/26/2018,13,931,922,928,1174,1090732,932,-4,-0.43
6/27/2018,57,935,921,930,5047,4684972,928,2,0.22
6/28/2018,46,955,931,931,2623,2458336,930,1,0.11
7/1/2018,57,945,925,928,4235,3928819,931,-3,-0.32
7/2/2018,37,928,917,920,2420,2230578,928,-8,-0.86
7/3/2018,48,926,918,920,5734,5276092,920,0,0
7/4/2018,71,920,913,917,6221,5705845,920,-3,-0.33
7/5/2018,141,928,919,924,12676,11688329,917,7,0.76
7/8/2018,102,953,928,940,12880,12053335,924,16,1.73
7/9/2018,91,941,918,918,11028,10191921,940,-22,-2.34
7/10/2018,53,926,917,917,3949,3635273,918,-1,-0.11
7/11/2018,81,928,917,918,9218,8488516,917,1,0.11
7/12/2018,77,922,911,912,5387,4937055,918,-6,-0.65
7/15/2018,70,920,912,920,5465,5011393,912,8,0.88
7/16/2018,102,921,903,921,10813,9814734,920,1,0.11
7/17/2018,364,917,899,900,64608,58183875,921,-21,-2.28
7/18/2018,150,905,897,900,28537,25684476,900,0,0
7/19/2018,282,905,898,900,36821,33135848,900,0,0
7/22/2018,74,900,897,900,6188,5564234,900,0,0
7/23/2018,96,900,898,900,11306,10173097,900,0,0
7/24/2018,173,905,898,899,20936,18838973,900,-1,-0.11
7/25/2018,81,900,897,897,7248,6515265,899,-2,-0.22
7/26/2018,75,908,899,905,13263,11940605,897,8,0.89
7/29/2018,63,919,909,910,5574,5081568,905,5,0.55
7/30/2018,46,913,907,909,5174,4704652,910,-1,-0.11
7/31/2018,58,910,905,905,5144,4667568,909,-4,-0.44
8/1/2018,56,910,904,908,5960,5399467,905,3,0.33
8/2/2018,53,909,904,906,5552,5025364,908,-2,-0.22
8/5/2018,71,907,900,905,6414,5793997,906,-1,-0.11
8/6/2018,62,907,900,903,6662,6014701,905,-2,-0.22
8/7/2018,42,919,904,904,2142,1939354,903,1,0.11
8/8/2018,36,910,903,904,2673,2418903,904,0,0
8/9/2018,40,922,904,909,3307,2995504,904,5,0.55
8/12/2018,67,910,894,900,6359,5711482,909,-9,-0.99
8/13/2018,44,907,900,907,5383,4849651,900,7,0.78
8/14/2018,51,907,900,907,6383,5763190,907,0,0
8/15/2018,163,940,913,935,17869,16481295,907,28,3.09
8/16/2018,186,966,930,957,17494,16648687,935,22,2.35
8/19/2018,134,965,954,959,11046,10576160,957,2,0.21
8/20/2018,106,960,942,948,9155,8697104,959,-11,-1.15
8/21/2018,71,947,940,940,4925,4641395,948,-8,-0.84
8/22/2018,35,945,935,945,2174,2048396,940,5,0.53
8/23/2018,60,945,941,945,4749,4479671,945,0,0
8/26/2018,63,948,944,945,5990,5664032,945,0,0
8/28/2018,60,950,943,949,6091,5781337,945,4,0.42
8/29/2018,36,949,945,947,3171,3001456,949,-2,-0.21
8/30/2018,54,952,945,947,5231,4957539,947,0,0
9/2/2018,73,952,946,950,7021,6664605,947,3,0.32
9/3/2018,80,970,955,964,7503,7217390,950,14,1.47
9/4/2018,80,971,961,966,8115,7858208,964,2,0.21
9/5/2018,90,974,965,970,10041,9723088,966,4,0.41
9/6/2018,141,984,963,965,16698,16255028,970,-5,-0.52
9/9/2018,55,974,955,970,7541,7272133,965,5,0.52
9/10/2018,52,967,960,964,7438,7154743,970,-6,-0.62
9/11/2018,34,969,960,966,6852,6594520,964,2,0.21
9/12/2018,26,967,965,965,4296,4148546,966,-1,-0.1
9/13/2018,52,970,966,968,5373,5204961,965,3,0.31
9/16/2018,59,974,968,969,9770,9476501,968,1,0.1
9/17/2018,34,970,965,968,1984,1919979,969,-1,-0.1
9/18/2018,54,970,966,968,5243,5077774,968,0,0
9/20/2018,57,970,960,962,6516,6276391,968,-6,-0.62
9/23/2018,37,964,950,961,3193,3067001,962,-1,-0.1
9/25/2018,50,965,960,965,5209,5014381,961,3,0.31
9/26/2018,74,969,960,966,9356,9023400,965,1,0.1
9/27/2018,32,970,960,961,3070,2955155,966,-5,-0.52
9/30/2018,43,961,950,950,7218,6875847,961,-11,-1.14
10/1/2018,39,956,934,945,2593,2457545,950,-5,-0.53
10/2/2018,41,950,940,945,3936,3714697,945,0,0
10/3/2018,49,945,932,942,5114,4797575,945,-3,-0.32
10/4/2018,61,958,916,944,5142,4793892,942,2,0.21
10/7/2018,50,944,927,927,5803,5418389,944,-17,-1.8
10/8/2018,33,944,927,929,3337,3103085,927,2,0.22
10/9/2018,29,939,927,930,2484,2309884,929,1,0.11
10/10/2018,41,932,927,930,4393,4083177,930,0,0
10/11/2018,39,937,929,931,5113,4765260,930,1,0.11
10/14/2018,20,939,935,938,1925,1805120,931,7,0.75
10/15/2018,18,956,940,953,1245,1176840,938,15,1.6
10/21/2018,6,955,950,953,193,183830,953,0,0
10/22/2018,26,959,950,951,1928,1836366,953,-2,-0.21
10/23/2018,21,960,950,960,2006,1914357,951,9,0.95
10/24/2018,35,970,956,962,3191,3062958,960,2,0.21
10/25/2018,16,963,956,956,1044,1003004,962,-6,-0.62
10/28/2018,38,956,939,942,2511,2375880,956,-14,-1.46
10/29/2018,38,945,939,940,2862,2696421,942,-2,-0.21
10/30/2018,23,945,940,940,1768,1665460,940,0,0
10/31/2018,20,952,940,952,2427,2290367,940,12,1.28
11/1/2018,23,949,940,946,1572,1486688,952,-6,-0.63
11/4/2018,33,947,938,940,2099,1973599,946,-6,-0.63
11/5/2018,35,940,935,938,2736,2564837,940,-2,-0.21
11/6/2018,4,951,940,946,130,122200,946,-6,-0.63
11/7/2018,378,951,940,0,12170,11551510,940,11,1.17
11/10/2018,4,951,940,946,130,122200,946,-6,-0.63
11/11/2018,31,946,897,911,2235,2049703,946,-35,-3.7
11/12/2018,49,911,897,0,4075,3671257,911,-7,-0.77
11/13/2018,11,921,905,919,833,765772,905,14,1.55
11/14/2018,33,920,915,919,4373,4012461,919,0,0
11/15/2018,55,940,919,927,7548,7014926,919,8,0.87
11/18/2018,38,930,916,917,3113,2861006,927,-10,-1.08
11/19/2018,31,918,908,917,2568,2343176,917,0,0
11/20/2018,13,918,902,902,760,689755,917,-15,-1.64
11/21/2018,33,906,890,906,3991,3590008,902,4,0.44
11/22/2018,42,915,900,900.34,4595,4161447,906,-5.66,-0.62
11/25/2018,42,904,898,898.76,3792,3411869,900.34,-1.58,-0.18
11/26/2018,44,898.76,888,888.58,5967,5315003,898.76,-10.18,-1.13
11/27/2018,42,899,885,889,4029,3590433,888.58,0.42,0.05
11/28/2018,58,900,888,889,5451,4856282,889,0,0
11/29/2018,52,890,882,882.14,3294,2918930,889,-6.86,-0.77
12/2/2018,49,882.14,865,865,4594,4012974,882.14,-17.14,-1.94
12/3/2018,53,875,862,863,3135,2724634,865,-2,-0.23
12/4/2018,150,863,841,860,13920,11836081,863,-3,-0.35
12/5/2018,90,860,849,851,7992,6810591,860,-9,-1.05
12/6/2018,57,851,830,850,6099,5146673,851,-1,-0.12
12/9/2018,51,856,850,852,4171,3551145,850,2,0.24
12/10/2018,82,860,850,853,8181,6985900,852,1,0.12
12/11/2018,52,860,844,855,3869,3292015,853,2,0.23
12/12/2018,43,860,845,851,3175,2698524,855,-4,-0.47
12/13/2018,51,855,847,847,4879,4154691,851,-4,-0.47
12/16/2018,66,859,847,853,9410,8028210,847,6,0.71
12/17/2018,35,869,850,862,2512,2156799,853,9,1.06
12/18/2018,43,862,856,858,5028,4313427,862,-4,-0.46
12/19/2018,43,860,850,850,7082,6065755,858,-8,-0.93
12/20/2018,47,860,845,851,3393,2889782,850,1,0.12
12/23/2018,54,870,851,870,8974,7768742,851,19,2.23
12/24/2018,36,876,865,868,5253,4559230,870,-2,-0.23
12/25/2018,25,870,855,862,1588,1363054,868,-6,-0.69
12/26/2018,60,870,860,864,7037,6076478,862,2,0.23
12/27/2018,64,880,864,865,6193,5420729,864,1,0.12
12/30/2018,48,877,865,866,4130,3580230,865,1,0.12
12/31/2018,67,879,860,860,7285,6272105,866,-6,-0.69
1/1/2019,48,863,851,851,5002,4299360,860,-9,-1.05
1/2/2019,35,859,850,850,5122,4367064,851,-1,-0.12
1/3/2019,65,855,841,841,9928,8406376,850,-9,-1.06
1/6/2019,61,848,835,837,7310,6131147,841,-4,-0.48
1/7/2019,35,840,835,835,4589,3841093,841,-6,-0.71
1/8/2019,48,839,835,837,3971,3320723,835,2,0.24
1/9/2019,48,840,834,834,4380,3665005,837,-3,-0.36
1/10/2019,59,848,834,835,5480,4594681,834,1,0.12
1/13/2019,32,851,835,838,3132,2630499,835,3,0.36
1/14/2019,50,844,830,836,4045,3380041,838,-2,-0.24
1/15/2019,27,842,834,842,2708,2274094,836,6,0.72
1/16/2019,41,858,841,845,2960,2495960,842,3,0.36
1/17/2019,39,845,836,844,2128,1789744,845,-1,-0.12
1/20/2019,31,850,844,850,3123,2644690,844,6,0.71
1/21/2019,33,848,836,843,3420,2879855,850,-7,-0.82
1/22/2019,32,845,841,842,1670,1408160,843,-1,-0.12
1/23/2019,52,850,838,838,4189,3525291,842,-4,-0.48
1/24/2019,34,843,838,840,2567,2157456,838,2,0.24
1/27/2019,43,841,832,838,3910,3264588,840,-2,-0.24
1/28/2019,35,838,832,834,2227,1857209,838,-4,-0.48
1/29/2019,70,835,830,830,6286,5226541,834,-4,-0.48
1/30/2019,61,841,830,837,3605,3021780,830,7,0.84
1/31/2019,53,844,837,841,4408,3704155,837,4,0.48
2/3/2019,52,845,840,841,4165,3504489,841,0,0
2/4/2019,69,841,825,829,5154,4282870,841,-12,-1.43
2/5/2019,30,835,829,830,2150,1786992,829,1,0.12
2/6/2019,48,830,825,828,3267,2700338,830,-2,-0.24
2/7/2019,32,835,826,831,3757,3121345,828,3,0.36
2/10/2019,34,831,820,824,2399,1978534,831,-7,-0.84
2/11/2019,30,830,823,825,3879,3206308,824,1,0.12
2/12/2019,43,830,825,825,2448,2022793,825,0,0
2/13/2019,48,830,818,822,3151,2590226,825,-3,-0.36
2/14/2019,36,825,818,818,2494,2045066,822,-4,-0.49
2/17/2019,59,829,807,807,6470,5260676,818,-11,-1.34
2/18/2019,254,815,778,783,29718,23363212,807,-24,-2.97
2/19/2019,105,795,776,793,7663,6056596,783,10,1.28
2/20/2019,99,793,780,789,9080,7134674,793,-4,-0.5
2/21/2019,135,803,789,803,17561,13943026,789,14,1.77
2/24/2019,158,810,792,795,15486,12382022,803,-8,-1
2/25/2019,308,799,789,794,31622,25071269,795,-1,-0.13
2/26/2019,162,708.93,678,687,9887,6780379,708.93,-21.93,-3.09
2/27/2019,48,689,681,687,4794,3287509,687,0,0
3/3/2019,84,691,680,682,8715,5981206,687,-5,-0.73
3/5/2019,60,690,681,683,6279,4299414,682,1,0.15
3/6/2019,69,688,680,686,10200,6992179,683,3,0.44
3/7/2019,61,690,685,688,7555,5187912,686,2,0.29
3/10/2019,25,691,686,691,1992,1371509,688,3,0.44
3/11/2019,100,700,691,696,16082,11171683,691,5,0.72
3/12/2019,126,720,696,720,12884,9192682,696,24,3.45
3/13/2019,118,731,715,715,11803,8544860,720,-5,-0.69
3/14/2019,43,720,708,715,3812,2724814,715,0,0
3/17/2019,85,730,715,722,9881,7160677,715,7,0.98
3/18/2019,70,730,722,722,9174,6660220,722,0,0
3/19/2019,16,724,718,723,1020,735840,722,1,0.14
3/21/2019,90,722,708,710,8927,6376826,723,-13,-1.8
3/24/2019,63,721,709,712,5859,4167379,710,2,0.28
3/25/2019,67,716,709,712,7028,5001380,712,0,0
3/26/2019,46,712,706,712,3898,2766912,712,0,0
3/27/2019,62,715,709,709,9163,6518505,712,-3,-0.42
3/28/2019,44,719,708,714,5004,3560176,709,5,0.71
3/31/2019,71,717,707,712,7019,4989641,714,-2,-0.28
4/1/2019,62,714,709,712,11973,8520113,712,0,0
4/2/2019,86,718,710,717,15403,10998068,712,5,0.7
4/3/2019,77,731,712,724,14196,10231962,717,7,0.98
4/4/2019,69,728,718,727,8188,5926768,724,3,0.41
4/7/2019,104,732,721,732,23725,17210067,727,5,0.69
4/8/2019,133,755,730,740,23599,17506141,732,8,1.09
4/9/2019,105,750,740,743,12325,9165403,740,3,0.41
4/10/2019,67,749,735,740,8232,6083115,743,-3,-0.4
4/11/2019,66,743,736,736,7882,5833869,740,-4,-0.54
4/15/2019,35,746,736,746,3377,2508067,736,10,1.36
4/16/2019,55,773,747,766,6057,4601029,746,20,2.68
4/17/2019,97,780,766,773,11183,8655913,766,7,0.91
4/18/2019,126,810,785,810,15287,12154425,773,37,4.79
4/21/2019,185,867,815,866,28899,24371418,810,56,6.91
4/22/2019,221,900,868,880,29675,26446983,866,14,1.62
4/23/2019,147,890,859,881,15000,13127950,880,1,0.11
4/24/2019,72,894,864,878,6811,5986456,881,-3,-0.34
4/25/2019,86,895,877,880,9441,8344073,878,2,0.23
4/28/2019,119,891,873,873,9506,8416974,880,-7,-0.8
4/29/2019,77,880,866,868,8403,7330752,873,-5,-0.57
4/30/2019,81,871,851,856,7584,6535452,868,-12,-1.38
5/2/2019,68,855,845,847,6201,5263300,856,-9,-1.05
5/5/2019,87,844,830,835,9479,7923076,847,-12,-1.42
5/6/2019,73,855,834,851,8355,7017752,835,16,1.92
5/7/2019,66,869,850,850,8243,7040204,851,-1,-0.12
5/8/2019,53,855,840,846,7578,6380515,850,-4,-0.47
5/9/2019,44,862,838,841,2950,2486583,846,-5,-0.59
5/12/2019,39,845,831,841,3539,2969502,841,0,0
5/13/2019,39,855,841,844,2652,2239367,841,3,0.36
5/14/2019,44,850,837,848,3614,3042368,844,4,0.47
5/15/2019,57,860,844,851,5163,4401510,848,3,0.35
5/16/2019,61,858,845,845,6365,5396030,851,-6,-0.71
5/19/2019,43,855,831,843,6356,5322545,845,-2,-0.24
5/20/2019,59,849,830,830,5507,4593487,843,-13,-1.54
5/21/2019,41,840,827,840,4169,3480164,830,10,1.2
5/22/2019,33,856,835,841,1981,1666961,840,1,0.12
5/23/2019,48,845,835,841,5508,4631903,841,0,0
5/26/2019,52,857,835,840,5463,4580200,841,-1,-0.12
5/27/2019,21,840,835,840,2539,2126755,840,0,0
5/28/2019,26,844,830,836,2822,2357557,840,-4,-0.48
5/29/2019,34,840,837,840,3151,2643739,836,4,0.48
5/30/2019,72,882,847,847,9146,7847192,840,7,0.83
6/2/2019,61,848,832,834,6077,5092634,847,-13,-1.53
6/3/2019,40,835,830,833,2874,2391215,834,-1,-0.12
6/4/2019,40,843,829,829,3935,3274335,833,-4,-0.48
6/6/2019,47,832,826,828,4877,4044107,829,-1,-0.12
6/10/2019,57,842,820,826,4518,3747090,828,-2,-0.24
6/11/2019,57,826,820,822,8030,6604807,826,-4,-0.48
6/12/2019,55,823,815,820,8943,7321965,822,-2,-0.24
6/13/2019,53,834,818,827,9849,8084710,820,7,0.85
6/16/2019,78,822,813,814,13511,11054441,827,-13,-1.57
6/17/2019,68,816,807,816,10347,8422115,814,2,0.25
6/18/2019,72,816,806,814,8230,6675233,816,-2,-0.25
6/19/2019,47,829,803,814,3158,2548422,814,0,0
6/24/2019,55,808,802,808,3446,2774340,805,3,0.37
6/25/2019,58,810,800,810,4883,3941709,808,2,0.25
6/26/2019,55,810,802,804,7826,6305130,810,-6,-0.74
6/27/2019,122,815,799,800,12955,10381928,804,-4,-0.5
6/30/2019,164,806,785,785,28406,22459703,800,-15,-1.88
7/1/2019,75,785,780,785,8539,6680735,785,0,0
7/2/2019,100,785,775,784,9500,7396723,785,-1,-0.13
7/3/2019,70,799,775,795,7949,6256691,784,11,1.4
7/4/2019,61,800,795,798,10401,8304199,795,3,0.38
7/7/2019,69,805,790,790,6481,5135732,798,-8,-1
7/8/2019,51,790,785,787,4253,3346218,790,-3,-0.38
7/9/2019,115,806,786,806,11678,9317059,787,19,2.41
7/10/2019,75,815,801,811,9931,8029610,806,5,0.62
7/11/2019,102,824,813,823,8966,7349011,811,12,1.48
7/14/2019,70,827,820,825,3781,3114375,823,2,0.24
7/15/2019,228,833,799,799,30861,24844803,825,-26,-3.15
7/16/2019,176,838,792,800,25920,20690486,799,1,0.13
7/17/2019,77,814,800,813,17512,14114496,800,13,1.63
7/18/2019,73,820,808,812,15304,12441575,813,-1,-0.12
7/21/2019,102,810,800,801,19195,15373045,812,-11,-1.35
7/22/2019,96,819,803,805,19698,15859921,801,4,0.5
7/23/2019,100,810,802,808,13387,10777123,805,3,0.37
7/24/2019,88,815,805,812,17884,14464085,808,4,0.5
7/25/2019,86,811,800,805,11336,9132402,812,-7,-0.86
7/28/2019,108,808,796,797,17431,13928301,805,-8,-0.99
7/29/2019,75,805,798,803,10970,8776221,797,6,0.75
7/30/2019,48,805,800,801,10926,8762095,803,-2,-0.25
7/31/2019,57,805,800,800,9199,7380782,801,-1,-0.12
8/1/2019,64,805,800,801,11281,9049631,800,1,0.13
8/4/2019,99,803,796,799,11095,8875676,801,-2,-0.25
8/5/2019,64,800,795,800,9946,7949617,799,1,0.13
8/6/2019,115,795,789,790,13321,10532439,800,-10,-1.25
8/7/2019,61,795,784,790,9174,7253945,790,0,0
8/8/2019,69,796,787,790,10432,8237900,790,0,0
8/11/2019,86,788,781,784,9920,7776326,790,-6,-0.76
8/12/2019,62,788,782,783,5650,4425270,784,-1,-0.13
8/13/2019,52,785,781,782,6190,4840872,783,-1,-0.13
8/14/2019,96,784,775,779,11640,9077408,782,-3,-0.38
8/15/2019,47,785,780,784,13055,10216347,779,5,0.64
8/18/2019,74,790,779,779,12387,9681667,784,-5,-0.64
8/19/2019,107,784,776,778,10297,8024707,779,-1,-0.13
8/20/2019,72,782,777,778,12518,9741646,778,0,0
8/21/2019,77,779,775,778,13659,10607288,778,0,0
8/22/2019,89,781,777,777,7473,5819886,778,-1,-0.13
8/25/2019,60,780,771,776,7386,5716394,777,-1,-0.13
8/26/2019,117,776,760,775,23330,17929030,776,-1,-0.13
8/27/2019,59,780,771,778,5949,4611481,775,3,0.39
8/28/2019,52,790,770,770,4274,3309179,778,-8,-1.03
8/29/2019,73,775,768,770,9213,7102386,770,0,0
9/1/2019,70,772,767,769,9261,7131662,770,-1,-0.13
9/2/2019,65,769,756,758,6969,5301083,769,-11,-1.43
9/3/2019,71,775,750,774,8894,6777484,758,16,2.11
9/4/2019,80,781,770,777,15241,11835353,774,3,0.39
9/5/2019,71,792,777,780,8861,6906071,777,3,0.39
9/8/2019,69,781,775,776,9562,7431867,780,-4,-0.51
9/9/2019,50,778,770,776,4931,3813681,776,0,0
9/10/2019,60,775,767,769,7569,5839289,776,-7,-0.9
9/11/2019,50,772,765,772,4673,3594701,769,3,0.39
9/12/2019,72,771,765,770,10514,8072324,772,-2,-0.26
9/15/2019,54,775,759,759,6359,4874908,770,-11,-1.43
9/16/2019,130,756,742,742,10591,7940938,759,-17,-2.24
9/17/2019,94,766,745,750,10137,7664052,742,8,1.08
9/18/2019,76,780,762,775,7924,6096104,750,25,3.33
9/19/2019,92,784,770,770,13287,10284442,775,-5,-0.65
9/22/2019,58,770,762,765,7591,5824754,770,-5,-0.65
9/23/2019,71,768,760,760,6194,4722361,765,-5,-0.65
9/24/2019,61,760,757,760,7998,6067393,760,0,0
9/25/2019,49,765,759,759,3910,2976459,760,-1,-0.13
9/26/2019,52,762,755,759,3989,3028699,759,0,0
9/29/2019,52,760,751,752,3598,2712199,759,-7,-0.92
9/30/2019,37,760,754,760,4706,3560706,752,8,1.06
10/1/2019,32,777,761,772,2719,2093259,760,12,1.58
10/2/2019,35,780,770,772,4486,3461626,772,0,0
10/3/2019,43,778,769,769,5226,4032416,772,-3,-0.39
10/10/2019,15,773,765,770,728,560034,769,1,0.13
10/14/2019,72,770,757,765,16518,12628679,770,-5,-0.65
10/15/2019,38,765,760,763,4973,3789781,765,-2,-0.26
10/16/2019,44,768,754,762,4902,3736305,763,-1,-0.13
10/17/2019,83,765,759,760,8157,6207023,762,-2,-0.26
10/20/2019,51,766,756,757,4145,3146446,760,-3,-0.39
10/21/2019,65,764,755,758,6056,4584792,757,1,0.13
10/22/2019,74,762,754,756,17493,13223055,758,-2,-0.26
10/23/2019,29,765,756,762,3122,2368174,756,6,0.79
10/24/2019,88,768,755,768,8808,6697374,762,6,0.79
10/31/2019,62,768,753,761,6352,4815541,768,-7,-0.91
11/3/2019,75,760,752,760,8041,6072107,761,-1,-0.13
11/4/2019,194,780,762,768,25965,19886453,760,8,1.05
11/5/2019,147,777,763,770,16182,12474125,768,2,0.26
11/6/2019,91,774,765,768,13493,10367567,770,-2,-0.26
11/7/2019,155,772,755,755,23312,17710571,768,-13,-1.69
11/10/2019,75,763,753,755,10153,7674441,755,0,0
11/11/2019,134,765,750,753,15505,11683992,755,-2,-0.26
11/12/2019,73,765,749,750,21447,16098257,753,-3,-0.4
11/13/2019,55,755,750,750,6681,5018811,750,0,0
11/14/2019,46,754,749,749,3797,2850847,750,-1,-0.13
11/17/2019,63,755,745,755,7383,5535999,749,6,0.8
11/18/2019,46,756,750,755,23592,17707953,755,0,0
11/19/2019,63,755,750,753,18207,13687430,755,-2,-0.26
11/20/2019,64,760,750,750,29088,21840959,753,-3,-0.4
11/21/2019,73,750,739,740,7681,5715781,750,-10,-1.33
11/24/2019,103,742,730,730,12391,9102857,740,-10,-1.35
11/25/2019,81,732,727,727,10567,7698944,730,-3,-0.41
11/26/2019,59,735,725,730,8682,6346523,727,3,0.41
11/27/2019,77,735,729,732,18463,13492130,730,2,0.27
11/28/2019,115,733,724,725,15634,11378111,732,-7,-0.96
12/1/2019,84,730,723,723,24232,17581984,725,-2,-0.28
12/2/2019,48,726,723,725,6572,4760969,723,2,0.28
12/3/2019,70,730,725,725,9589,6958164,725,0,0
12/4/2019,70,729,725,725,9772,7096626,725,0,0
12/5/2019,60,737,728,730,13130,9587208,725,5,0.69
12/8/2019,90,739,725,729,11013,8040885,730,-1,-0.14
12/9/2019,47,749,730,736,5466,4029498,729,7,0.96
12/10/2019,50,745,736,743,4466,3314343,736,7,0.95
12/11/2019,65,750,743,747,8847,6602367,743,4,0.54
12/12/2019,67,751,744,749,16206,12117258,747,2,0.27
12/15/2019,109,755,744,744,16928,12680177,749,-5,-0.67
12/16/2019,62,750,737,737,11742,8718734,744,-7,-0.94
12/17/2019,93,747,739,743,9416,6998419,737,6,0.81
12/18/2019,121,750,742,748,15298,11410627,743,5,0.67
12/19/2019,120,755,749,753,15015,11292183,748,5,0.67
12/22/2019,158,760,750,756,34362,25925141,753,3,0.4
12/23/2019,385,762,750,750,66023,49968524,756,-6,-0.79
12/24/2019,190,670,660,667,22863,15219265,669.64,-2.64,-0.39
12/25/2019,92,669,665,669,12220,8153503,667,2,0.3
12/26/2019,118,677,665,676,14538,9770117,669,7,1.05
12/29/2019,106,679,673,674,14830,10016237,676,-2,-0.3
12/30/2019,81,687,673,675,17063,11519190,674,1,0.15
12/31/2019,81,682,676,681,15116,10266502,675,6,0.89
1/1/2020,71,690,680,690,10882,7441866,681,9,1.32
1/2/2020,92,690,684,685,20018,13735671,690,-5,-0.72
1/5/2020,95,699,690,697,17152,11916616,685,12,1.75
1/6/2020,176,715,700,713,23487,16704357,697,16,2.3
1/7/2020,180,734,719,722,24397,17667225,713,9,1.26
1/8/2020,117,725,715,721,17879,12888985,722,-1,-0.14
1/9/2020,78,723,711,716,9624,6898033,721,-5,-0.69
1/12/2020,161,728,720,726,30359,22021006,716,10,1.4
1/13/2020,191,749,726,730,40571,29778694,726,4,0.55
1/14/2020,99,735,716,730,12535,9134077,730,0,0
1/15/2020,75,743,733,740,11175,8250209,730,10,1.37
1/16/2020,182,759,740,751,26914,20279439,740,11,1.49
1/19/2020,176,766,757,764,22863,17437789,751,13,1.73
1/20/2020,180,780,755,761,25615,19608879,764,-3,-0.39
1/21/2020,129,767,749,755,18428,13899962,761,-6,-0.79
1/22/2020,91,756,745,745,12755,9571027,755,-10,-1.32
1/23/2020,146,745,722,727,19663,14402288,745,-18,-2.42
1/26/2020,192,727,709,712,20914,14935615,727,-15,-2.06
1/27/2020,119,729,706,720,17628,12688880,712,8,1.12
1/28/2020,101,735,725,725,15203,11093084,720,5,0.69
1/29/2020,83,732,721,724,10541,7633236,725,-1,-0.14
1/30/2020,113,737,724,736,14728,10794169,724,12,1.66
2/2/2020,176,754,740,752,37634,28186301,736,16,2.17
2/3/2020,205,758,733,738,33172,24608597,752,-14,-1.86
2/4/2020,148,744,732,739,27241,20084904,738,1,0.14
2/5/2020,83,739,734,734,20827,15333803,739,-5,-0.68
2/6/2020,119,740,726,726,15362,11219692,734,-8,-1.09
2/9/2020,115,732,720,721,18422,13329862,726,-5,-0.69
2/10/2020,148,727,716,720,23380,16839330,721,-1,-0.14
2/11/2020,151,730,715,723,27491,19884891,720,3,0.42
2/12/2020,89,729,721,722,11735,8502428,723,-1,-0.14
2/13/2020,118,727,721,723,16258,11739379,722,1,0.14
2/16/2020,143,726,719,724,17985,12980031,723,1,0.14
2/17/2020,237,757,728,750,51893,38522632,724,26,3.59
2/18/2020,242,765,744,753,47604,35781874,750,3,0.4
2/19/2020,124,753,746,751,23379,17521598,753,-2,-0.27
2/20/2020,145,755,746,755,21585,16200829,751,4,0.53
2/23/2020,376,804,758,790,65129,51428772,755,35,4.64
2/24/2020,440,821,791,800,93540,75251218,790,10,1.27
2/25/2020,236,814,779,814,37640,30262975,800,14,1.75
2/26/2020,448,875,828,870,83212,70799650,814,56,6.88
2/27/2020,788,955,845,955,167082,153067578,870,85,9.77
3/1/2020,952,1000,936,940,163043,157426240,955,-15,-1.57
3/2/2020,478,939,850,850,68203,61903748,940,-90,-9.57
3/3/2020,807,910,815,888,150206,130046377,850,38,4.47
3/4/2020,662,888,838,847,107177,91614291,888,-41,-4.62
3/5/2020,440,852,813,840,78904,65853297,847,-7,-0.83
3/10/2020,264,824,776,776,60824,48387865,840,-64,-7.62
3/11/2020,513,822,766,815,83501,66473957,776,39,5.03
3/12/2020,469,831,784,790,65403,52330864,815,-25,-3.07
3/15/2020,527,787,748,750,70304,53590197,790,-40,-5.06
3/16/2020,365,764,723,750,55501,41379236,750,0,0
3/17/2020,396,765,721,731,46620,34056347,750,-19,-2.53
3/18/2020,373,739,700,715,43913,31255827,731,-16,-2.19
3/19/2020,394,740,690,730,55806,40326364,715,15,2.1
3/22/2020,119,744,700,701,15101,10711884,730,-29,-3.97
5/12/2020,16,687,680,680,2295,1574600,701,-21,-3
5/13/2020,8,667,660,660,435,287170,680,-20,-2.94
6/29/2020,274,680,594,660,40720,25230100,660,0,0
6/30/2020,79,726,670,725,8769,6202588,660,65,9.85
7/1/2020,91,770,725,770,15536,11885951,725,45,6.21
7/2/2020,137,785,702,720,21024,15291417,770,-50,-6.49
7/5/2020,275,734,699,729,59244,42413482,720,9,1.25
7/6/2020,186,740,715,737,32963,24070284,729,8,1.1
7/7/2020,257,751,740,744,41752,31110796,737,7,0.95
7/8/2020,205,756,730,741,30143,22236187,744,-3,-0.4
7/12/2020,167,770,746,747,27529,20670172,742,5,0.67
7/13/2020,184,769,741,742,28339,21192710,747,-5,-0.67
7/14/2020,164,760,742,745,29973,22359330,742,3,0.4
7/16/2020,326,790,774,790,38787,30413146,765,25,3.27
7/19/2020,10,869,805,869,711,604099,790,79,10
7/20/2020,837,955,816,879,118430,104333835,869,10,1.15
7/21/2020,508,886,857,865,69536,60373203,879,-14,-1.59
7/22/2020,342,875,846,846,51597,44171652,865,-19,-2.2
7/23/2020,305,854,831,850,55386,46772267,846,4,0.47
7/26/2020,345,870,853,861,58534,50327555,850,11,1.29
7/27/2020,437,882,860,860,104636,90909055,861,-1,-0.12
7/28/2020,248,872,854,854,51916,44557821,860,-6,-0.7
7/29/2020,331,855,840,845,45527,38537876,854,-9,-1.05
7/30/2020,253,854,840,851,41463,34949018,845,6,0.71
8/2/2020,522,850,820,820,63388,52644301,851,-31,-3.64
8/3/2020,311,828,808,824,42609,34937444,820,4,0.49
8/6/2020,223,859,801,814,21551,17436075,819,-5,-0.61
8/9/2020,277,815,800,813,36927,29733955,814,-1,-0.12
8/10/2020,285,840,810,832,47830,39607700,813,19,2.34
8/11/2020,239,847,825,830,29776,24910631,832,-2,-0.24
8/12/2020,163,844,821,836,23975,19932023,830,6,0.72
8/13/2020,309,877,820,825,36200,30028322,836,-11,-1.32
8/16/2020,235,835,810,822,29088,23880845,825,-3,-0.36
8/17/2020,155,824,815,822,16623,13631013,822,0,0
8/18/2020,159,840,824,830,20561,16999400,822,8,0.97
8/19/2020,166,825,814,822,17216,14104730,830,-8,-0.96
8/20/2020,94,822,812,817,10175,8322334,822,-5,-0.61
8/23/2020,110,824,814,824,14020,11472416,817,7,0.86
8/24/2020,188,835,825,830,22795,18913879,824,6,0.73
8/25/2020,191,840,823,830,23396,19393753,830,0,0
8/26/2020,312,850,830,841,44021,36884764,830,11,1.33
8/27/2020,249,855,841,845,23000,19440692,841,4,0.48
8/31/2020,337,846,832,839,49117,41228199,839,0,0
9/2/2020,430,866,839,858,68044,58383099,839,19,2.26
9/3/2020,341,864,849,860,54696,46996807,858,2,0.23
9/6/2020,406,903,854,855,56147,48599327,860,-5,-0.58
9/7/2020,232,863,842,849,19865,16851726,855,-6,-0.7
9/8/2020,198,858,840,846,21968,18533893,849,-3,-0.35
9/9/2020,286,846,839,844,36262,30535485,846,-2,-0.24
9/10/2020,257,868,844,845,26842,22754668,844,1,0.12
9/13/2020,275,855,845,849,32164,27216200,845,4,0.47
9/14/2020,313,870,852,856,33179,28459824,849,7,0.82
9/15/2020,257,864,853,856,31304,26877416,856,0,0
9/16/2020,205,858,850,853,15690,13408729,856,-3,-0.35
9/17/2020,293,865,851,859,33660,28905002,853,6,0.7
9/20/2020,548,895,870,880,72747,64108046,859,21,2.44
9/21/2020,498,892,876,883,61628,54378128,880,3,0.34
9/22/2020,384,890,870,871,51572,45326423,883,-12,-1.36
9/23/2020,187,877,866,874,30912,26921675,871,3,0.34
9/24/2020,214,877,866,875,23476,20511293,874,1,0.11
9/27/2020,222,883,870,874,23447,20496239,875,-1,-0.11
9/28/2020,222,885,868,871,17676,15400876,874,-3,-0.34
9/29/2020,271,875,862,864,20446,17694728,871,-7,-0.8
9/30/2020,244,875,857,859,22250,19158319,864,-5,-0.58
10/1/2020,287,869,860,867,30640,26539772,859,8,0.93
10/4/2020,366,895,875,880,52843,46554462,867,13,1.5
10/5/2020,200,889,872,876,22147,19501801,880,-4,-0.45
10/6/2020,175,885,872,877,18761,16443686,876,1,0.11
10/7/2020,242,882,868,872,26029,22719444,877,-5,-0.57
10/8/2020,241,882,866,869,27048,23575489,872,-3,-0.34
10/11/2020,232,870,864,866,24647,21356190,869,-3,-0.35
10/12/2020,175,865,860,864,19390,16732449,866,-2,-0.23
10/13/2020,147,865,861,864,15218,13128546,864,0,0
10/14/2020,284,865,859,860,29183,25112911,864,-4,-0.46
10/15/2020,261,872,817,860,25564,22063813,860,0,0
10/18/2020,190,874,859,859,18801,16186884,860,-1,-0.12
10/19/2020,134,868,860,863,11314,9745814,859,4,0.47
10/20/2020,108,872,862,868,11628,10100283,863,5,0.58
10/21/2020,315,884,870,880,30592,26834284,868,12,1.38
10/22/2020,318,893,880,885,46895,41512626,880,5,0.57
10/28/2020,522,903,892,903,59283,53276411,885,18,2.03
10/29/2020,468,948,898,902,51398,46533552,903,-1,-0.11
11/1/2020,339,902,890,894,40311,36037361,902,-8,-0.89
11/2/2020,271,897,884,886,29989,26645462,894,-8,-0.89
11/3/2020,172,897,884,888,15950,14133088,886,2,0.23
11/4/2020,197,890,884,888,20507,18177641,888,0,0
11/5/2020,322,890,875,880,34927,30744588,888,-8,-0.9
11/8/2020,536,880,864,870,72463,62957972,880,-10,-1.14
11/9/2020,640,872,858,862,90972,78516171,870,-8,-0.92
11/10/2020,236,890,865,879,29034,25457758,862,17,1.97
11/11/2020,247,896,872,883,41751,36680964,879,4,0.46
11/12/2020,249,891,883,887,36591,32463221,883,4,0.45
11/18/2020,455,905,888,901,61321,54937368,887,14,1.58
11/19/2020,588,953,900,905,94311,85560341,901,4,0.44
11/22/2020,1284,985,920,965,229261,221824547,905,60,6.63
11/23/2020,596,994,969,978,75761,74141154,965,13,1.35
11/24/2020,399,1000,960,972,58491,56962154,978,-6,-0.61
11/25/2020,1290,1029,972,1038,295613,296235333,972,66,6.79
11/26/2020,2145,1141,1050,1130,343732,383441401,1038,92,8.86
11/29/2020,1788,1200,1141,1185,283683,335607869,1130,55,4.87
11/30/2020,1429,1244,1150,1159,196359,229713140,1185,-26,-2.19
12/1/2020,1491,1165,1115,1119,177245,201194660,1159,-40,-3.45
12/2/2020,1225,1147,1096,1125,205216,231653897,1119,6,0.54
12/3/2020,969,1196,1106,1140,159437,182433622,1125,15,1.33
12/6/2020,1286,1145,1078,1078,161986,179567029,1140,-62,-5.44
12/7/2020,1118,1147,1057,1118,164879,180793589,1078,40,3.71
12/8/2020,778,1162,1115,1124,113824,128740310,1118,6,0.54
12/9/2020,612,1135,1095,1101,77270,85573625,1124,-23,-2.05
12/10/2020,606,1127,1094,1120,86977,96928167,1101,19,1.73
12/13/2020,791,1165,1064,1159,110589,126540741,1120,39,3.48
12/14/2020,1570,1248,1160,1227,273113,327906859,1159,68,5.87
12/15/2020,1104,1293,1202,1240,161533,200111684,1227,13,1.06
12/16/2020,927,1254,1200,1248,149009,184859975,1240,8,0.65
12/17/2020,714,1255,1228,1235,101916,126238866,1248,-13,-1.04
12/20/2020,1625,1246,1175,1207,323547,392321090,1235,-28,-2.27
12/21/2020,1590,1236,1160,1231,263971,317629142,1207,24,1.99
12/22/2020,244,1354,1292,1354,48213,65191252,1231,123,9.99
12/23/2020,1042,1489,1400,1489,187508,279179932,1354,135,9.97
12/24/2020,3916,1550,1403,1425,425873,614965941,1489,-64,-4.3
12/27/2020,2280,1450,1381,1384,290409,404921356,1425,-41,-2.88
12/28/2020,1534,1395,1360,1379,176237,243416028,1384,-5,-0.36
12/29/2020,3132,1400,1380,1386,381895,530177990,1379,7,0.51
12/30/2020,2644,1108,1048,1101,240703,261693768,1038,63,6.07
12/31/2020,1211,1130,1100,1100,126022,140476169,1101,-1,-0.09
1/3/2021,1192,1130,1080,1125,152668,168109683,1100,25,2.27
1/4/2021,667,1136,1102,1111,91228,102321107,1125,-14,-1.24
1/5/2021,569,1118,1095,1097,90991,100390256,1111,-14,-1.26
1/6/2021,564,1104,1086,1096,76530,83523572,1097,-1,-0.09
1/7/2021,625,1112,1042,1091,77627,84901592,1096,-5,-0.46
1/10/2021,1135,1134,1095,1126,182457,203939412,1091,35,3.21
1/11/2021,562,1182,1120,1125,67113,76129051,1126,-1,-0.09
